1 1 1 1 1 1 1 1 1 1 1 1 1 1 1 1 1 1 1 1 1 1 1 1 1 1 1 1 1 1
1 3 2 2 2 2 2 2 2 2 2 2 2 2 2 2 2 2 2 2 2 2 2 2 2 2 2 2 9 1
1 4 0 0 0 0 0 16 16 16 16 16 16 16 16 16 16 16 16 16 16 16 16 16 16 16 16 0 8 1
1 4 0 0 0 0 0 16 16 16 16 16 16 16 16 16 16 16 16 16 16 16 16 16 16 16 16 0 8 1
1 4 0 0 0 0 0 16 16 16 16 16 16 16 16 16 16 16 16 16 16 16 16 16 16 16 16 0 8 1
1 4 0 0 10 12 12 12 12 12 12 12 12 12 12 12 12 12 12 12 12 12 12 12 12 14 0 0 8 1
1 4 0 0 11 13 13 13 13 13 13 13 13 13 13 13 13 13 13 13 13 13 13 13 13 15 0 0 8 1
1 4 0 17 17 0 0 0 0 0 0 0 20 0 0 0 0 0 21 0 0 0 0 0 0 18 18 0 8 1
1 4 0 17 17 0 0 0 0 0 0 0 0 0 19 0 0 0 0 19 0 0 0 0 0 18 18 0 8 1
1 4 0 17 17 0 0 0 0 0 22 22 22 22 22 22 0 0 0 0 20 0 0 0 0 18 18 0 8 1
1 4 0 17 17 0 0 23 0 0 0 0 0 0 0 0 0 0 0 0 0 0 0 0 0 18 18 0 8 1
1 4 0 17 17 0 0 0 0 0 0 0 0 0 0 0 0 0 0 0 0 0 0 0 0 18 18 0 8 1
1 4 0 17 17 0 0 0 0 23 0 0 0 0 0 0 0 0 0 0 0 0 0 0 23 18 18 0 8 1
1 4 0 17 17 0 23 0 0 0 0 0 0 0 0 0 0 0 0 0 0 21 0 0 0 18 18 0 8 1
1 4 0 17 17 0 0 0 23 0 22 22 22 22 22 22 0 0 0 0 19 0 0 0 0 18 18 0 8 1
1 4 0 17 17 0 0 0 0 0 0 0 0 0 0 0 0 0 0 0 0 0 0 23 0 18 18 0 8 1
1 4 0 17 17 0 0 0 0 0 0 20 0 0 19 0 0 0 0 0 0 0 0 0 0 18 18 0 8 1
1 4 0 0 0 0 0 21 0 0 0 0 19 0 0 0 0 0 0 0 23 0 0 0 0 18 18 0 8 1
1 5 6 6 6 6 6 6 6 6 6 6 6 6 6 6 6 6 6 6 6 6 6 6 6 6 6 6 7 1
1 1 1 1 1 1 1 1 1 1 1 1 1 1 1 1 1 1 1 1 1 1 1 1 1 1 1 1 1 1
